Arabella Allen: Arabella, Miss Allen, Mrs. Winkle
Benjamin Allen: Benjamin, Mr. Allen
Mr Ayresleigh: Ayresleigh
Bagman: Bagman
Jack Bamber: Bamber, little old man
Angelo Cyrus Bantam: Bantam
Martha Bardell: Mrs. Bardell
Tom Bardell: Master Bardell
Henry Beller: Beller
Betsy: Betsy
Bill: Boll
Prince Bladud: Bladud
Sir Thomas Blazo: Blazo
Mr Blotton: Blotton
Boffer: Boffer
Captain Boldwig: Boldwig 
Miss Bolo: Bolo
Brooks: Brooks
Brown: Bruwn
Mrs Budger: Budger
Colonel Bulder: Colonel Bulder
Mrs Bulder: Mrs. Colonel Bulder
Miss Bulder: Miss Bulder
Bullman: Bullman
Mrs Bunkin: Bunkin
Thomas Burton: Burton
Serjeant Buzfuz: Buzfuz
Chancery Prisoner: Chancery prisoner
Charley: Charley
Clergyman: clergyman
Thomas Clubber: Sir Thomas Clubber
Lady Clubber: Lady Clubber
Misses Clubber: Misses Clubber
Mrs Cluppins: Mrs. Cluppins
Mrs Craddock: Mrs. Craddock
Mr Crawley: Mr. Crawley
Tom Cripps: Cripps, boy in gray, boy in the gray livery
Crookey: Crookey
Mr Crushton: Crushton
Dodson: Dodson
Fogg: Fogg
Mr Dowler: Dowler
Mrs Dowler: Mrs. Dowler
Dubbley: Dubbley
Mr Dumkins: Dumkins
John Edmunds: Edmunds
Emma: Emma
Marquess of Filletoville: Filletoville
Horatio Fizkin: Fizkin
Don Bolaro Fizzgig: Fizzgig
Wilkins Flasher: Flasher, Wlkns Flasher
Goodwin: Goodwin
Thomas Groffin: Groffin
Gabriel Grub: Gabriel Grub
Daniel Grummer: Grummer
Mr Grundy: Grundy
Mr Gunter: Gunter
Miss Gwynn: Gwynn
Harris: Harris
George Heyling: Heyling
Jack Hopkins: Hopkins
Anthony Humm: Humm
Hunt: Hant
Mrs Hunter: Mrs. Leo Hunter
Mr Hunter: Mr. Leo Hunter
Jem Hutley: Jemmy, Hutley
Isaac: Isaac
Jane1: Jane1
Jane2: Jane2
Jane Wugsy: JaneW 
Jackson: Jackson
Alfred Jingle: Fitz-Marshall, Jingle
Mr Jinkins: Jinkins
Mr Jinks: Jinks
Joe: Joe, fat boy
St John: Jahn 
Kate: Kate
Maria Lobbs: Maria Lobbs
Old Lobbs: old Lobbs
Mr Lowten: Lowten
Sololomon Lucas: Lucas
Lud Hudibaras: Lud
Mr Luffey: Luffey
Peter Magnus: Magnus
Mr Mallard: Mallard
Sir Geoffrey Manning: Sir Geoffrey
Game Martin: Maltin
Surly Martin: Murtin 
Betsey Martin: Betsy Martin
Jack Martin: Jack Martin
Tom Martin: Tom Martin, Mr. Martin
Mary: Mary
Misses Matinter: Matinter
Mr Miller: Mr. Miller
Mr Mivins: Mivins, Zephyr
Brother Mordlin: Mordlin
Mrs Mudberry: Mudberry
Jonas Mudge: Mudge
Lord Mutanhed: Mutanhed
Muzzle: Muzzle
Mr Namby: Namby
Neddy: Neddy
Mr Noddy: Noddy
Mr Nupkins: Mr. Nupkins
Mrs Nupkins: Mrs. Nupkins
Miss Nupkins: Miss Nupkins
Doctor Payne: Payne
Solomon Pell: Pell
Mr Perker: Perker
Mr Phunky: Phunky
Samuel Pickwick: Pickwick
Nathaniel Pipkin: Pipkin
Mr Podder: Podder
Mrs Porkenham: Mrs. Porkenham
Misses Porkenham: Misses Porkenham
Mr Porkenham: Sidney Porkenham
Mr Pott: Mr. Pott
Mrs Pott: Mrs. Pott
Mr Price: Mr. Price
Pruffle: Pruffle
Quanko Samba: Quanko
Mrs Raddle: Mrs. Raddle
Mr Raddle: Mr. Raddle
Mrs Rogers: Mrs. Rogers
Tom Roker: Roker
Sam: Saam
Mrs Sanders: Mrs. Sanders
Bob Sawyer: Bob, Sawyer
Frank Simmery: Simmery
Mr Simpson: Simpson
Mr Skimpin: Skimpin
Doctor Slammer: Slammer
Mr Slasher: Slasher
Hon Slumkey: Slumkey
The Slummintowkens: Slummintowkens
Mr Slurk: Slurk 
Mr Smangle: Smangle
Tom Smart: Tom Smart
John Smauker: Smauker
Joe Smiggers: Smiggers
Miss Smithers: Smithers
Mr Smithies: Mr. Smithie
Mrs Smithe: Mrs. Smithie
Misses Smithie: Misses Smithie
Count Smorltork: Smorltork
Mr Smouch: Smouch
Mr Snicks: Snicks
Hon Snipe: Snipe
Augustus Snodgrass: Snodgrass
Serjeant Snubbin: Snubbin
Dowager Snuphanuph: Snuphanuph
Mr Staple: Staple
Mr Stareleigh: Stareleigh
Mr Stiggins: Stiggins
Mr Struggles: Struggles
Brother Tadger: Tadger
Lieutenant Tappleton: Tappleton
Tommy: Timmy
Miss Tomkins: Tomkins
Mrs Tomlinson: Tomlinson
Job Trotter: Job, Trotter
Mr Trundle: Trundle
Mr Tuckle: Tuckle
Tracy Tupman: Tupman
Richard Upwitch: Upwitch
H Walker: H. Walker
Mr Wardle: Mr. Wardle
Mrs Wardle: Mrs. Wardle, the old lady
Emily Wardle: Emily
Isabella Wardle: Isabella, Bella
Rachael Wardle: Rachael
Mr Watty: Watty
Sam Weller: Sam
Tony Weller: Tony, Mr. Weller
Mrs Weller: Susan, Mrs. Weller
Mr Whiffers: Whiffers
Whiffin: Whiffin
Mr Wicks: Wicks
Tom Wildspark: Wildspark
Wilkins: Wilkins
Nathaniel Winkle: Mr. Winkle, Nathaniel
Mr Winkle: WinkleSr
Miss Witherfield: Witherfield
Mrs Wugsby: Wugsby
