Young Bailey: Bailey
Mr Bevan: Bevan
Julius Bib: Julius Bib
Jeff Brick: Mr Brick, Jefferson Brick
Oscar Buffum: Buffum
Bullamy: Bullamy
Chiggle: Chiggle
General Choke: General Choke, Cyrus Choke
Major Chollop: Chollop
Chuffey: Chuffey
Anthony Chuzzlewit: Anthony
George Chuzzlewit: George
Jonas Chuzzlewit: Jonas
Martin Jr: Martin
Martin Sr: Old, Mr Chuzzlewit
Mrs Ned Chuzzlewit: Mrs Ned, strong-minded
Cicero: Cicero
Miss Codger: Codger
David Crimple: Crimple
Colonel Diver: Colonel Diver
Doctor Dunkle: Dunkle
Mr Fips: Fips
General Fladdock: Fladdock
Mrs Gamp: Gamp
Mr Gander: Gander
Mrs Gill: Mrs Gill
Mary: _Mary, Miss Graham
Colonel Groper: Groper
Mrs Hominy: Hominy
Mr Izzard: Izzard
Jack Coach: Jakk
Jane: Jane
Mr Jinkins: Jinkins
Doctor Jobling: Jobling
Jodd: Jodd
Captain Kedgick: Kedgick
La Fayette Kettle: Kettle
Lewsome: Lewsome
Lummy Ned: Lummy
Mrs Lupin: Lupin
Augustus Moddle: Moddle, Augustus, youngest gentleman
Tigg Montague: Tigg, Montague
Mr Mould: Mr Mould
Mrs Mould: Mrs Mould
Misses Mould: Misses Mould
Professor Mullit: Mullit
Nadgett: Nadgett
Mr Norris: Mr Norris
Mrs Norris: Mrs Norris
Major Pawkins: Major Pawkins
Mrs Pawkins: Mrs Pawkins
Charity Pecksniff: Charity
Mercy Pecksniff: Mercy
Seth Pecksniff: Mr Pecksniff
Ruth Pinch: _Ruth, Miss Pinch
Tom Pinch: _Tom, Mr Pinch
Mr Pip: Mr Pip
Professor Piper: Professor Piper
Pogram: Pogram
Mrs Prig: Mrs Prig, Betsey
Zephaniah Scadder: Scadder
William Simmons: Simmons
Chevy Slyme: Slyme
Putnam Smif: Smif
Sophia: Sophia
Mr/Mrs Spottletoe: Spottletoe
Poll Sweedlepipe: Sweedle
Tacker: Tacker
Tamaroo: Tamaroo
Mrs Todgers: Mrs Todgers
Miss Toppit: Toppit
John Westlock: John, Westlock
Mr Wolf: Mr Wolf
Mark Tapley: Mark, Mr Tapley
Anonymous Woman: NONNY
