Mr Badger: Badger, Mr. Badger
Mrs Badger: Mrs. Badger, Mrs. Bayham Badger
Matthew Bagnet: Mr. Bagnet, Matthew Bagnet, Lignum
Mrs Bagnet: Mrs. Bagnet
Malta Bagnet: Malta
Quebec Bagnet: Quebec
Woolwich Bagnet: Woolwich
Miss Barbary: Miss Barbary
Mrs Blinder: Blinder
Mr Blowers: Blower
James George Bogsby: Bogsby
Lord Boodle: Boodle
Lawrence Boythorn: Boythorn
Inspector Bucket: Mr. Bucket, Inspector Bucket
Mrs Bucket: Mrs. Bucket
William Buffy: Buffy
Richard Carstone: Richard, Mr. Carstone
Reverend Chadband: Mr. Chadband, Reverend Chadband
Mrs Chadband: Mrs. Rachael, Mrs. Chadband
Charley: Charley, Charlotte
Ada Clare: Ada, Miss Clare
Coavinses: Coavinses, Neckett
Darby: Darby
Lady Dedlock: my Lady, Lady Dedlock, Honoria, 
Sir Dedlock: Sir Leicester
Volumnia Dedlock: Volumnia
Professor Dingo: Dingo
Miss Donny: Miss Donny
Miss Flite: Flite
Mr Gridley: Gridley, man from Shropshire
Mr Grubble: Grubble
William Guppy: Guppy
Mrs Guppy: Mrs. Guppy
Guster: Guster
Mr Gusher: Gusher
Captain Hawden: Nemo, Hawdon
Mademoiselle Hortense: Hortense, mademoiselle
John Jarndyce: cousin John, John Jarndyce, Mr. Jarndyce
Caroline Caddy: Caddy, Caroline
Mrs Jellyby: Mrs. Jellyby
Mr Jellyby: Mr. Jellyby
Peepy Jellby: Peepy
Jenny: Jenny
Jo: Jo, Toughey, crossing-sweeping boy
Jobling: Weevle, Jobling, Tony
Conversation Kenge: Mr. Kenge, Conversation Kenge
Krook: Krook
Liz: Liz
Miss Melvilleson: Melvilleson 
Mercury: Mercury
Mooney: Mooney
Emma Neckett: Emma
Tom Neckett: TomNeckett
Mr Pardiggle: Mr. Pardiggle
Mrs Pardiggle: Mrs. Pardiggle
Alfred Pardiggle: Alfred
Egbert Pardiggle: Egbert
Francis Pardiggle: Francis
Oswald Pardiggle: Oswald
Peffer: Peffer
Mrs Perkins: Perkins
Mrs Piper: Mrs. Piper
Polly: Polly
Priscilla: Priscilla
Mr Quale: Quale
Rosa: Rosa
George Rouncewell: Mr. George, George Rouncewell
Mr Rouncewell: Mr. Rouncewell
Mrs Rouncewell: Mrs. Rouncewell
Watt Rouncewell: Watt
Mr Skimpole: Mr. Skimpole, Harold
Mrs Skimpole: Mrs. Skimpole
Arethusa Skimpole: Arethusa, Beauty daughter
Kitty Skimpole: Kitty, Comedy
Laura Skimpole: Laaaura, Sentiment
Sladdery: Sladdery
Bartholomew Smallweed: Bartholomew, Chick, Young Smallweed, Bart
Grandfather Smallweed: Grandfather, Mr. Smallweed
Mrs Smallweed: Mrs. Smallweed
Judy Smallweed: Judy
Mr Snagsby: Mr. Snagsby
Mrs Snagsby: Mrs. Snagsby
Phil Squod: Phil, Mr. Squod
Bob Stables: Stables
Esther Summerson: Esther, Dame Durden, Mother Hubbard, Mrs. Shipton
Little Swills: Swills
Captain Swosser: Captain Swosser
Mr Tangle: Tangle
Thomas: Thummas
Mr Tulkinghorn: Tulkinghorn, the lawyer
Mr Turveydrop: Mr. Turveydrop
Prince Turvey: Prince
Vholes: Vholes
Miss Wisk: Wisk
Allan Woodcourt: Allan, Mr. Woodcourt
Mrs Woodcourt: Mrs. Woodcourt
