Sophronia Akershem: Sophronia Akershem, Sophronia, Mrs Alfred Lammle, Mrs Lammle
Analytical Chemist: the Analytical, Analytical chemist, the chemist
Blight: Blight
Tom Bocker: Tom Bocker
Mr Boffin: Mr Boffin, Nicodemus Boffin, Noddy, the Golden Dustman
Mrs Boffin: Mrs Boffin
Boots Brewer: Brewer
Jenny Wren: Fanny Cleaver, Jenny Wren, Jenny, Miss Wren, dressmaker
Mr Dolls: Mr Dolls, bad child
Fledgeby: Fledgeby
Bob Glamour: Bob Glamour
Bob Gliddery: Bob Gliddery
Mrs Goody: Mrs Goody
Mr Grompus: Mr Grompus
Gruff and Glum: Gruff and Glum
John Harmon: John Harmon, Mr John Harmon, Mr Harmon, Julius Handford, Mr Handford, John Rokesmith, Mr Rokesmith, John, Secretary
Harrison: Harrison
Aunt Hawkinson: aunt Hawkinson 
Bradley Headstone: Bradley Headstone, Mr Headstone, Bradley, schoolmaster
Charley Hexam: Charley Hexam, Mr Hexam, Charley
Gaffer Hexam: Jesse Hexam, Gaffer Hexam, Gaffer
Lizzie Hexam: Lizzie Hexam, Miss Hexam, Lizzie, Mrs Eugene Wrayburn, Mrs Eugene
Betty Higden: Mrs Higden, Betty
Mr Inspector: Mr Inspector
Captain Joey: Captain Joey, the Captain
Johnny: Johnny
Jonathan: Jonathan 
George Jones: George Jones, Jones
Jacob Kibble: Jacob Kibble, Mr Kibble
Alfred Lammle: Mr Alfred Lammle, Alfred Lammle, Mr Lammle, Alfred
Mortimer Lightwood: Mortimer Lightwood, Mr Lightwood, Mortimer
Mary Anne: Mary Anne
Reverend  FrankMilvey: Reverend Frank Milvey, Reverend Frank, Mr Milvey
Mrs Milvey: Mrs Milvey, Mrs Frank, Margaretta
Jack Mullins: Jack Mullins
Miss Peecher: Miss Peecher, Emma Peecher
Georgiana Podsnap: Miss Podsnap, Georgiana Podsnap, Georgiana
Mr Podsnap: John Podsnap, Mr Podsnap
Mrs Podsnap: Mrs Podsnap
Abbey Potterson: Miss Abbey Potterson, Miss Potterson, Miss Abbey, Abbey
Job Potterson: Job Potterson
Mr Riah: Riah, Jew
Pleasant Riderhood: Pleasant Riderhood, Miss Riderhood, Miss Pleasant
Rogue Riderhood: Rogue Riderhood, Riderhood, Roger, Rogue
George Sampson: Sampson
Sloppy: Sloppy
Lord Snigsworth: Snigsworth
Mrs Sprodgkin: Mrs Sprodgkin
Mrs Swoshle: Mrs Henry George Alfred Swoshle
The Tapkins: Tapkins
Lady Tippins: Lady Tippins
Toddles: Toddles
Poddles: Poddles
Tom Tootle: Tootle
Melvin Twemlow: Twemlow
Mr Veneering: Hamilton Veneering, Hamilton, Mr Veneering, Veneering
Mrs  Veneering: Anastasia Veneering, Anastasia, Mrs Veneering
MrVenus: Venus
Silas Wegg: Silas Wegg, Mr Wegg, Silas
Bella Wilfer: Bella Wilfer, Miss Wilfer, Bella, Mrs John Harmon, Mrs John Rokesmith, Mrs Rokesmith
Lavinia Wilfer: Lavinia Wilfer, Lavinia, Lavvy
Mrs Wilfer: Mrs Wilfer
Mr Wilfer: Reginald, R. Wilfer, Mr Wilfer, Wilfer, Pa
William Williams: William Williams
Eugene Wrayburn: Eugene Wrayburn, Eugene, Wrayburn, Governor
