Lady Alicia: Lady Alicia
Miss Atkinson: Miss Atkinson
Admiral Baldwin: Admiral Baldwin
Captain Benwick: James Benwick, Benwick, Captain Benwick
Admiral Brand: Admiral Brand
Captain Brigden: Captain Brigden, Brigden
The Honourable Miss Carteret: Miss Carteret, 
Mrs Penelope Clay: Penelope, Mrs Clay, 
Admiral Croft: Admiral Croft, Admiral
Mrs Croft: Mrs Croft, Sophy, Sophia 
The Late Viscount Dalrymple: the late viscount
The Dowager Countess Dalrymple: Lady Dalrymple, Dowager Viscountess Dalrymple, 
Sir Archibald Drew: Sir Archibald Drew
Anne Elliot: Miss Elliot, god-daughter, Anne, Anne Elliot
Elizabeth Elliot: Elizabeth Elliot, Elizabeth
Mary Elliot: Mary, Mary Elliot, Mary Musgrove, Mrs Charles 
Sir Walter Elliot: Sir Walter
Lady Elliot: Lady Elliot, daughter of James Stevenson
Mr William Elliot: Mr Elliot, Sir William, William Walter Elliot
Mrs William Elliot: a very fine woman
Mrs Frankland: Mrs Frankland
Lady Mary Grierson: Lady Mary Grierson
Captain Harville: Captain Harville, Harville
Mrs Harville: Mrs Harville 
Fanny Harville: Fanny, Miss Harville
Mr Hayter: Mr Hayter
Mrs Hayter: Mrs Hayter
Charles Hayter: Charles Hayter, Cousin Charles
The Miss Hayters: The Miss Hayters
Jemima: Jemima
Mackenzie: Mackenzie
Lady Mary Maclean: Lady Mary Maclean
Mary: Marie
Sir Basil Morley: Sir Basil
Elder Mr Charles Musgrove: Mr Musgrove
Charles Musgrove: Charles, Charles Musgrove 
Mrs Musgrove: Mrs Musgrove 
Little Charles Musgrove: Little Charles, invalid Charles 
Harry Musgrove: Master Harry
Henrietta Musgrove: Henrietta, other Miss Musgrove, the youngest Miss Musgrove, Miss Musgrove of Uppercross
Louisa Musgrove: Louisa, Miss Musgrove, 
Dick Musgrove: Dick 
Walter Musgrove: Walter
Mr Robinson: Mr Robinson
Nurse Rooke: Mrs Rooke, Nurse Rooke
Sir Henry Russell: Sir Henry Russell
Lady Russell: Lady Russell
Sarah: Sarah
Mr John Shepherd: Mr Shepherd, John Shepherd
Doctor Shirley: Dr Shirley
Mrs Shirley: Mrs Shirley
Charles Smith: Smith, Charles Smith
Mrs Smith: Miss Hamilton, Mrs Smith
Mrs Speed: Mrs Speed
Lord St Ives: Lord St Ives
Governor Trent: Governor Trent
Colonel Wallis: Colonel Wallis
Mrs Wallis: Mrs. Wallis
Edward Wentworth: Edward, Mr Wentworth, curate of Monkford
Captain Frederick Wentworth: Frederick, Captain Wentworth, Wentworth
